111111111111111
100010000010001
101010111010101
101000000000101
101110101011101
101000000000101
100011101110001
101001345100101
101101111101101
101000000000101
100010111010001
101010000010101
101000111000101
101101000101101
100000010000001
101110010011101
101000111000101
101010010010101
100011020110001
111111111111111
