111111111111111
100000000000001
101011101110101
101011101110101
100000101000001
101010000010101
100011101110001
101014345410101
101011111110101
100011000110001
111000010000111
100011010110001
101010010010101
101000111000101
101111111111101
100000000000001
101110101011101
101000101000101
101011101110101
100000020000001
111111111111111
