111111111111111
100000000000001
101101111101101
100100000001001
110101010101011
100001000100001
101011141110101
101001345100101
101101111101101
101000010000101
100011010110001
101000000000101
101011111110101
101000000000101
101010101010101
100010101010001
111010101010111
100010000010001
101111101111101
100000020000001
111111111111111
