111111111111111
100000000000001
101010111010101
101010000010101
101011101110101
100000000000001
110101141101011
100101345101001
101101111101101
101000000000101
100011111110001
101010000010101
101000111000101
101110000011101
101000101000101
100010101010001
101010000010101
101011101110101
100000020000001
111111111111111
