111111111111111
100000000000001
101101101101101
100001000100001
101011010110101
101000000000101
101101141101101
101101345101101
100101111101001
110000000000011
100101111101001
101101111101101
100100010001001
100001010100001
101101010101101
101000010000101
101011010110101
100001000100001
101101101101101
100000020000001
111111111111111
